11111111111111111111111111111
1E0000000000000C0000000000001
10100101001000001010010000011
101001001010101000100100C0011
1P0000000000C0000000000000001
11111111111111111111111111111