1111111111111111111111111111111111111111111111111111
1111000000000000000000000000000000000000000000000001
100000000000000C111111111100000000000000000000000001
1000000000000000000000000000000000000000000111111111
100000000001111111111110000000000P000000001111000001
1000000000111111000000000000000000000000001100000001
1000000000000000001111111111111111000000001111000001
1000000000000000000000C10000000010000000000111100001
1011111000000000000000001100000000C00000000000000001
1000010000000000000000010000000001000000000000000001
10C1111000000000000000010C00001111111111111111111111
1000000001111111111111111111110000000000000000000001
1000000000000000000000000000100000000000000000000001
100000000000001001010000001E000000000000000000000001
100000000000000000000000000C100000000000000000000001
1111111111111111111111111111111111111111111111111111