111111111111111111111111111111111111111111111111
100000000000000000000000000000000000000000000011
100000000000001000000000000000000000010000000011
100000000000000000000000001000000000000000000011
100001000000000000000000000000000000000000000011
100000000000000000000000000000000000000000000011
100000000000000000000000000000000000000000000011
100000000000000010000000000000000000000000000011
100000000000000000000000000000000000000000000011
100000000000000000000000000000000000000000000011
100000000000000000000000000000000000000000000011
100000000100000001000000000000000000001000000011
100000000000000000000000000000000000000000000011
100000000000000000000000000000000000000000000011
10000000000C000000100000000000000010000000000011
100001000000000000000000000000000000000000000011
100000000000000000000000000000000000000000000011
100000000000000000000000000000000000000000000011
100000000000000000000000000000000000000000000011
100000000000000000000000000000000000001000000011
100000000000000001000000000000000000000000000011
100000100000000000000000000000000000E00000000011
100000000000000000000000000000000000000000000011
100000000000010000000000000000000000000000000011
100000000000000000000000010000000000000000000011
10000000P000000000000000000000000000000000000011
100000000000000000000000000000000000000000000011
100000000000000000000000000000000000000000000011
100000000000000000000000000000000100000000000011
100000000000000000000000000000000000000000000011
111111111111111111111111111111111111111111111111